#####################################################
#           #                         #             #
#           #          #              #             #
######                  #             #             #
#         ########       #      ###   ####   ##     #
#                      #        #             #     #
#  ####                #     ####                   #
#     #      #####     #        #       #           #
#     #       #        #     ####       #     #     #
#             #                         #     #     #
######    #####                    #    #  ##########
#             #       #####        #                #
#             #           #    #####                #
#     ####            #####        #   ####   #     #
#        #        #                #   #      ##### #
#        #        #                    #            #
#  ###   #        ######       ####    #            #
#    #        #        #          #         #   #   #
#    #        #           #    #  #         #   #   #
#  ###        #    #   ####    #  ######    #   #   #
#        ######    #                        #       #
#                  #                        #       #
#####################################################